Summer Hits
The soundtrack of the Summer 2019.

49. Obsessed -- Ina Wroldsen, Dynoro -- Obsessed
24. Outta My Head (with John Mayer) -- Khalid, John Mayer -- Free Spirit
50. Summer Lover (feat. Devin & Nile Rodgers) -- Oliver Heldens, Devin, Nile Rodgers -- Summer Lover (feat. Devin & Nile Rodgers)
52. Changes -- Mike Perry, Dimitri Vangelis & Wyman, Ten Times, The Companions -- Changes
15. So Am I -- Ava Max -- So Am I
37. All Day And Night - Jax Jones & Martin Solveig Present Europa -- Jax Jones, Martin Solveig, Madison Beer, Europa -- Snacks
28. One Day (feat. ROZES) -- Sam Feldt, Yves V, ROZES -- One Day (feat. ROZES)
55. Next To You (feat. Rvssian) -- Digital Farm Animals, Becky G, Rvssian -- Next To You (feat. Rvssian)
32. 3 Nights -- Dominic Fike -- Don't Forget About Me, Demos
43. Hey Look Ma, I Made It -- Panic! At The Disco -- Pray For The Wicked
34. The Middle -- Zedd, Maren Morris, Grey -- The Middle
14. Youngblood -- 5 Seconds of Summer -- Youngblood (Deluxe)
29. no tears left to cry -- Ariana Grande -- Sweetener
05. Nobody -- Martin Jensen, James Arthur -- Nobody
54. All Around The World (La La La) -- R3HAB, A Touch Of Class -- All Around The World (La La La)
46. La Libertad -- Alvaro Soler -- Mar De Colores (Versión Extendida)
01. I Don't Care (with Justin Bieber) -- Ed Sheeran, Justin Bieber -- I Don't Care (with Justin Bieber)
11. No New Friends -- Sia, Diplo, Labrinth, LSD -- No New Friends
48. Enemy -- Sandro Cavazza -- Enemy
07. Woke Up Late (feat. Hailee Steinfeld) -- Drax Project, Hailee Steinfeld -- Woke Up Late (feat. Hailee Steinfeld)
06. Carry On (from the Original Motion Picture "POKÉMON Detective Pikachu") -- Kygo, Rita Ora -- Carry On (from the Original Motion Picture "POKÉMON Detective Pikachu")
44. All You Need To Know (feat. Calle Lehmann) -- Gryffin, SLANDER, Calle Lehmann -- All You Need To Know (feat. Calle Lehmann)
08. What I Like About You (feat. Theresa Rex) -- Jonas Blue, Theresa Rex -- What I Like About You (feat. Theresa Rex)
13. Sixteen -- Ellie Goulding -- Sixteen
17. ME! (feat. Brendon Urie of Panic! At The Disco) -- Taylor Swift, Brendon Urie -- ME!
20. Better When You're Gone -- David Guetta, Brooks, Loote -- Better When You're Gone
25. Stay (Don't Go Away) [feat. Raye] -- David Guetta, RAYE -- Stay (Don't Go Away) [feat. Raye]
18. On My Way -- Alan Walker, Sabrina Carpenter, Farruko -- On My Way
02. Sucker -- Jonas Brothers -- Sucker
30. Recognise -- Lost Frequencies, Flynn -- Recognise
38. Never Go Back -- Dennis Lloyd -- Exident
36. Who's Got Your Love -- Cheat Codes, Daniel Blume -- Who's Got Your Love
33. Do You Mean (with Ty Dolla $ign & bülow) -- The Chainsmokers, Ty Dolla $ign, bülow -- World War Joy...Do You Mean
51. Undrunk -- FLETCHER -- Undrunk
09. Don't Call Me Up -- Mabel -- Ivy To Roses (Mixtape)
39. I Miss Myself (with HRVY) -- NOTD, HRVY -- I Miss Myself (with HRVY)
45. Piece Of Your Heart -- MEDUZA, Goodboys -- Piece Of Your Heart
31. Con Calma -- Daddy Yankee, Snow -- Con Calma
42. Sing It With Me -- JP Cooper, Astrid S -- Sing It With Me
04. If I Can't Have You -- Shawn Mendes -- If I Can't Have You
47. Speaker (feat. Olivia Holt & ZieZie) -- Banx & Ranx, Olivia Holt, ZieZie -- Speaker (feat. Olivia Holt & ZieZie)
03. Polaroid -- Jonas Blue, Liam Payne, Lennon Stella -- Blue
26. Body On My -- Loud Luxury, Pitbull, Nicky Jam, Brando -- Body On My
23. Solo (feat. Demi Lovato) -- Clean Bandit, Demi Lovato -- Solo (feat. Demi Lovato)
12. SOS -- Avicii, Aloe Blacc -- SOS
41. Bittersweet Symphony (feat. Emily Roberts) -- GAMPER & DADONI, Emily Roberts -- Bittersweet Symphony (feat. Emily Roberts)
35. I Could Get Used To This -- Becky Hill, Weiss (UK) -- I Could Get Used To This
16. Selfish -- Dimitri Vegas & Like Mike, Era Istrefi -- Selfish
19. Summer Days (feat. Macklemore & Patrick Stump of Fall Out Boy) -- Martin Garrix, Macklemore, Fall Out Boy -- Summer Days (feat. Macklemore & Patrick Stump of Fall Out Boy)
53. Better Now -- Post Malone -- beerbongs & bentleys
27. One Kiss (with Dua Lipa) -- Calvin Harris, Dua Lipa -- One Kiss (with Dua Lipa)
10. Girls Like You (feat. Cardi B) -- Maroon 5, Cardi B -- Red Pill Blues (Deluxe)
21. Insomnia -- Daya -- Insomnia
22. Paradise -- Bazzi -- Paradise
40. Baila Baila Baila -- Ozuna -- Baila Baila Baila